c10/c10/c10/c10/t11/  0/  0/  0/  0/  0/  0/  0/  0/  0/  0/  0/  0/  0/
  0/  0/  0/  0/c13/  0/  0/  0/  0/  0/  0/  0/  0/t12/c10/c10/t11/  0/
  0/  0/  0/  0/c13/  0/  0/  0/  0/  0/  0/  0/  0/c11/  0/  0/c13/  0/
  0/  0/  0/  0/c13/  0/  0/  0/  0/  0/  0/  0/  0/c11/  0/  0/c13/  0/
  0/  0/  0/  0/c13/  0/  0/  0/  0/  0/  0/  0/  0/c11/  0/  0/c13/  0/
  0/  0/  0/  0/c13/  0/  0/  0/  0/  0/  0/  0/  0/c11/  0/  0/c13/  0/
  0/  0/  0/  0/c13/  0/  0/  0/  0/  0/  0/  0/  0/c11/  0/  0/c13/  0/
  0/  0/  0/  0/c13/v10/v10/v10/v10/v10/v10/v10/v10/c11/  0/  0/c13/  0/
  0/  0/  0/  0/t23/c10/c10/c10/c10/c10/c10/c10/c10/t20/  0/  0/c13/k13/
  0/  0/  0/  0/  0/  0/  0/  0/  0/  0/  0/  0/  0/  0/  0/  0/t23/v10/
  0/  0/  0/  0/  0/  0/  0/  0/  0/  0/  0/  0/  0/  0/  0/  0/  0/v10/
