  0/  0/  0/  0/  0/  0/  0/  0/  0/  0/  0/  0/  0/  0/  0/  0/  0/  0/
  0/  0/  0/  0/  0/  0/  0/  0/  0/  0/  0/  0/  0/  0/  0/  0/  0/  0/
  0/  0/  0/  0/  0/  0/  0/  0/  0/  0/t12/c10/c10/c10/t11/  0/  0/  0/
  0/  0/  0/  0/  0/  0/  0/  0/  0/t12/t20/  0/  0/  0/c13/  0/  0/  0/
  0/  0/  0/  0/  0/  0/  0/  0/t12/t20/  0/  0/  0/  0/c13/  0/  0/  0/
c10/c10/t11/  0/  0/  0/  0/t12/t20/  0/  0/  0/t22/c12/t10/  0/  0/  0/
  0/  0/c13/  0/  0/  0/t12/t20/  0/  0/  0/  0/c13/  0/  0/  0/  0/  0/
  0/  0/c13/  0/  0/t12/t20/  0/  0/  0/  0/  0/c13/  0/  0/  0/  0/  0/
  0/  0/c13/  0/t12/t20/  0/  0/  0/  0/  0/t12/x10/c10/t11/t12/c10/  0/
  0/  0/t23/c10/t20/  0/  0/  0/  0/  0/  0/t13/t10/  0/t23/t20/  0/  0/
  0/  0/  0/  0/  0/  0/  0/  0/  0/  0/  0/  0/  0/  0/  0/  0/  0/  0/
