  0/  0/  0/  0/  0/  0/  0/  0/  0/  0/  0/  0/  0/  0/  0/  0/  0/  0/
  0/  0/  0/  0/  0/  0/  0/  0/  0/  0/  0/  0/  0/  0/  0/  0/  0/  0/
  0/  0/  0/  0/t22/c12/t21/  0/  0/  0/  0/  0/  0/  0/  0/  0/  0/  0/
  0/  0/  0/t12/x10/t11/t13/t21/  0/  0/  0/  0/  0/  0/  0/  0/  0/  0/
  0/  0/t12/x10/x10/x10/t11/t13/t21/  0/  0/  0/  0/  0/  0/  0/  0/k13/
c10/c10/x10/t20/c13/t23/x10/t11/t13/t21/  0/  0/t12/c10/c10/c10/c10/v10/
  0/  0/t13/c12/t10/  0/t23/x10/t11/t13/t21/  0/c11/  0/  0/  0/  0/v10/
  0/  0/  0/  0/  0/  0/  0/t23/x10/t11/c11/  0/c11/  0/  0/  0/  0/  0/
  0/  0/  0/  0/  0/  0/  0/  0/t23/x10/x10/c10/t20/  0/  0/  0/  0/  0/
  0/  0/  0/  0/  0/  0/  0/  0/  0/t23/t20/  0/  0/  0/  0/  0/  0/  0/
  0/  0/  0/  0/  0/  0/  0/  0/  0/  0/  0/  0/  0/  0/  0/  0/  0/  0/
