  0/  0/  0/  0/  0/  0/  0/  0/  0/  0/  0/  0/  0/  0/  0/  0/  0/  0/
  0/  0/t12/c10/c10/c10/c10/c10/c10/c10/c10/c10/c10/c10/c10/t11/  0/  0/
  0/  0/c11/  0/  0/  0/  0/  0/  0/  0/  0/  0/  0/  0/  0/c13/  0/  0/
  0/t12/t20/  0/  0/  0/  0/  0/  0/  0/  0/  0/  0/  0/  0/t23/t11/  0/
  0/c11/  0/  0/  0/  0/  0/  0/  0/  0/  0/  0/  0/  0/  0/  0/c13/  0/
  0/t13/t21/  0/  0/  0/  0/  0/  0/  0/  0/  0/  0/  0/  0/t22/t10/  0/
  0/  0/c11/  0/  0/  0/  0/  0/  0/  0/  0/  0/  0/  0/  0/c13/  0/  0/
  0/t12/t20/  0/  0/  0/  0/  0/  0/  0/  0/  0/  0/  0/  0/t23/t11/  0/
  0/c11/  0/  0/  0/  0/  0/  0/  0/  0/  0/  0/  0/  0/  0/  0/c13/k13/
c10/t20/  0/  0/  0/  0/  0/  0/  0/  0/  0/  0/  0/  0/  0/  0/t23/v10/
  0/  0/  0/  0/  0/  0/  0/  0/  0/  0/  0/  0/  0/  0/  0/  0/  0/v10/
